{
	"77":"A1",
	"78":"A1",
	"88":"A1",
	"89":"A1",
	"90":"A1",
	"91":"A1",
	"564":"A1",
	"917":"A1",
	"943":"A1",
	"256":"A2",
	"287":"A2",
	"308":"A2",
	"384":"A2",
	"522":"A2",
	"523":"A2",
	"613":"A2",
	"620":"A2",
	"640":"A2",
	"220":"A3",
	"295":"A3",
	"311":"A3",
	"312":"A3",
	"319":"A3",
	"320":"A3",
	"325":"A3",
	"326":"A3",
	"327":"A3",
	"328":"A3",
	"359":"A3",
	"611":"A4",
	"776":"A4",
	"22":"A5",
	"284":"A5",
	"285":"A5",
	"425":"A5",
	"639":"A5",
	"16":"A6",
	"209":"A6",
	"548":"A6",
	"79":"A7",
	"502":"A8",
	"613":"223",
	"613":"778"
}